#..............#
#..............#
#..............#
#....!..c......#
##########...###
#..c.........#.#
#...........#..#
#..........#...#
#.........#....#
#.....####.....#
#..............#
##......x....c.#
#....##........#
#...#.......####
#..............#
##.......##....#
###............#
#......##......#
#..............#
#.##...........#
#......##......#
#c.............#
#...........####
####...........#
#..c.....##....#
#.##...........#
#.....##.......#
##.............#
################